1111111111111
100100C000001
1C0001111101
1P0011E000001
1111111111111