11111111111111111111111111111111111111111111111111111
1E0000000000000C00000C0000000000000101001000E00010101
1010010100100000101001000E000101000100001000000010101
101C0100101010100010010000000100000100001000C00010101
1P0000000C00C0000000000000000000C001000000C0000010101
10100101001000001010010000000100000100001000E00010101
10100100101010100010010000000100000001001000000010101
100000000000C0000000000001000000C00000001000000010101
1010010100100E001010010000000101000000001000000010101
10100100101010100010010000000101000101001000000010101
100000000C0000000000000000000000C00001001000100010101
1010010100100000101001000E0001010C01010000000E0000101
10100100101010100010010000000101000101001000E00010101
10000000000000000000000000000000C00000000000000010101
11111111111111111111111111111111111111111111111111111